--------------------------------!
--------------------------------!
--------------------------------!
--------------------------------!
--------------------------------!
--------------------------------!
--------------------------------!
--------------------------------!
--------------------------------!
--------------------------------!
--------------------------------!
11111111111111111111111111111111!
1------------------------------1!
1------------------------------1!
11111111111111111111111111111111!
1------------------------------1!
1------------------------------1!
11111111111111111111111111111111!
1------------------------------1!
1------------------------------1!
12222222222222222222222222222221!
1------------------------------1!
--------------------------------!
--------------------------------!
!!!!!!!!!!!!!!!!!!!!!!!!!!!!!!!!!

//COMMENT: max size is locked to 32x24 rectangle
// "!" symbol does nothing, it's just a visual border
//0 is blue brick
//1 is red brick
//2 is yellow brick
//3 is gray brick