--------------------------------!
--------------------------------!
--------------------------------!
--------------------------------!
--------------------------------!
--------------------------------!
--------------------------------!
----222222222222222222222222----!
---20000000000000000000000002---!
--2000000000000000000000000002--!
-200002222200000000002222200002-!
20000021112000000000021112000002!
-200002222200000000002222200002-!
--2000000000000000000000000002--!
---20000000000000000000000002---!
----200000000001100000000002----!
-----2000000000110000000002-----!
------20000000000000000002------!
-------200000000000000002-------!
--------2000000000000002--------!
---------20222000022202---------!
----------200222222002----------!
-----------2000000002-----------!
------------20000002------------!
!!!!!!!!!!!!!!!!!!!!!!!!!!!!!!!!!

//COMMENT: max size is locked to 32x24 rectangle
// "!" symbol does nothing, it's just a visual border
//0 is blue brick
//1 is red brick
//2 is yellow brick
//3 is gray brick