--------------------------------!
--------------------------------!
--------------------------------!
--------------------------------!
--------------------------------!
--------------------------------!
--------------------------------!
---------------00---------------!
--------------0000--------------!
------------00000000------------!
----------000000000000----------!
--------0000000000000000--------!
------00000000000000000000------!
----000000000000000000000000----!
--0000000000000000000000000000--!
00000000000000000000000000000000!
--0000000000000000000000000000--!
----000000000000000000000000----!
------00000000000000000000------!
--------0000001111000000--------!
----------000022220000----------!
------------00222200------------!
--------------0000--------------!
---------------00---------------!
!!!!!!!!!!!!!!!!!!!!!!!!!!!!!!!!!

//COMMENT: max size is locked to 32x24 rectangle
// "!" symbol does nothing, it's just a visual border