--------------------------------!
-------------0202020202020202020!
------------02020202020202020202!
-----------020202020202020202020!
----------0202020202020202020202!
---------02020202020202020202020!
--------020202020202020202020202!
-------0202020202020202020202020!
------02020202020202020202020202!
-----020202020202020202020202020!
----0202020202020202020202020202!
---02020202020202020202020202020!
--020202020202020202020202020202!
-0202020202020202020202020202020!
02020202020202020202020202020202!
--------------------------------!
--------------------------------!
--------------------------------!
--------------------------------!
--------------------------------!
--------------------------------!
--------------------------------!
--------------------------------!
--------------------------------!
!!!!!!!!!!!!!!!!!!!!!!!!!!!!!!!!!

//COMMENT: max size is locked to 32x24 rectangle
// "!" symbol does nothing, it's just a visual border
//0 is blue brick
//1 is red brick
//2 is yellow brick
//3 is gray brick