--------------------------------!
--------------------------------!
--------------------------------!
--------------------------------!
--------------------------------!
--------------1111--------------!
-00-00-00-00--0000--00-00-00-00-!
--------------------------------!
-000000000000000000000000000000-!
--------------------------------!
-00-00-00-00--0000--00-00-00-00-!
--------------------------------!
-000000000000000000000000000000-!
--------------------------------!
-00-00-00-00--0000--00-00-00-00-!
--------------------------------!
-----0000000000000000000000-----!
----000000000000000000000000----!
---00000000000000000000000000---!
--0000000000000000000000000000--!
-000000000000000000000000000000-!
-000000000000000000000000000000-!
--------------------------------!
--------------------------------!
!!!!!!!!!!!!!!!!!!!!!!!!!!!!!!!!!

//COMMENT: max size is locked to 32x24 rectangle
// "!" symbol does nothing, it's just a visual border
//0 is blue brick
//1 is red brick
//2 is yellow brick
//3 is gray brick