--------------------------------!
--------------------------------!
--------------------------------!
----333333333333333333333333----!
----3----------------------3----!
----3----------------------3----!
----3----------------------3----!
----3---11------------11---3----!
----3---11------------11---3----!
----3---11------------11---3----!
----3---11------------11---3----!
----3----------------------3----!
----3----------------------3----!
----3----------00----------3----!
----3----------00----------3----!
----3----------------------3----!
----3----------------------3----!
----3----------------------3----!
----3----------------------3----!
----3----------------------3----!
----3--111111111111111111--3----!
--------------------------------!
--------------------------------!
--------------------------------!
!!!!!!!!!!!!!!!!!!!!!!!!!!!!!!!!!

//COMMENT: max size is locked to 32x24 rectangle
// "!" symbol does nothing, it's just a visual border
//0 is blue brick
//1 is red brick
//2 is yellow brick
//3 is gray brick