--------------------------------!
--------------------------------!
--------------------------------!
------333--------------333------!
------333--------------333------!
------333--------------333------!
------333--------------333------!
------333--------------333------!
--------------------------------!
--3--------------------------3--!
---3------------------------3---!
----3----------------------3----!
-----3--------------------3-----!
------333--------------333------!
--------3333333333333333--------!
--------------------------------!
--------------------------------!
--------------------------------!
--------------------------------!
--------------------------------!
--------------------------------!
--------------------------------!
--------------------------------!
--------------------------------!
!!!!!!!!!!!!!!!!!!!!!!!!!!!!!!!!!

//COMMENT: max size is locked to 32x24 rectangle
// "!" symbol does nothing, it's just a visual border
//0 is blue brick
//1 is red brick
//2 is yellow brick
//3 is gray brick